20,20
44444444444444444444
40000000000000000004
40000000000000000504
40000000000000000004
40004444444444440004
40004000000000040004
40404030000000040004
40004444444400040004
40000000000000040004
40500000000000040004
40000000000000040004
44444444444444440004
40000000000000000004
40100000000000000004
40000000000000000004
44444444444444444444
40000000000000000004
40020202020202020204
40000000000000000004
44444444444444444444