30,20
444444444444444444444444444444
422222222400000000000000000004
455555555400000000000000000004
466666666400003000000030000004
477777777400000000000000000004
488888888400000000000000000004
444444444400000000000000000004
400000000000000000000000000004
400000000000000000000000000004
400000000000000000000000000004
400000000000000000000000000004
400000000000000000000000000004
401000000000000000000000000004
400000000000000000000000000004
400000000000000000000000000004
400000000000000000000000000004
400000000000000000000000000004
401000000000000000000000000004
400000000000000000000000000004
444444444444444444444444444444
