16,20
4444444444444444
4000000000000004
4003000000000004
4000000000000004
4444444444440004
4444444444440004
4444444444440004
4444444444440004
4444444444440004
4444444444440004
4444444444440004
4444444444440004
4000000000000004
4010000000000004
4000000000000004
4444444444444444
4000000000000004
4020200000000004
4000000000000004
4444444444444444