21,20
444444444444444444444
400000000040000000004
400003000040000300004
400000000040000000004
405044444444444440504
400000000040000000004
400000000040000000004
444444405040504444444
400000000040000000004
400000000040000000004
444444444444444444444
400000000000000000004
400000000000000000004
400000000000000000004
401000000000000000004
444444444444444444444
400202020202020202004
400000000000000000004
400606060607070707004
444444444444444444444
