21,20
444444444444444444444
400000000040000000004
400000000040000300004
400005000040000000004
400000000040000000004
444444400044444000444
400000000040000000004
400000000040000000004
400000000040000444444
400000000040000000004
444000044440000000004
400000000044444400004
400000000040000000004
401000000040000000504
400000000040000000004
444444444444444444444
400000000000000000004
400202020202020606004
400000000000000000004
444444444444444444444