16,20
4444444444444444
4000000000000004
4030000500000004
4000000000000004
4000000000000004
4444444440000444
4000000000000004
4000050000000004
4440000444444444
4000000000000004
4000000000000004
4444444440000444
4000000000050004
4010000000000004
4000000000000004
4444444444444444
4000000000000004
4020202020000004
4000000000000004
4444444444444444